HSK1_Word	HSK2_Word	HSK3_Word	HSK4_Word
啊	阿	哎哟	哀悼
啊	阿拉伯语/阿拉伯文	唉	哀求
矮	阿姨	挨	艾滋病
爱	挨	癌	爱戴
爱人	哎	安	爱面子
安静	哎呀	安定	爱惜
安排	爱好	安装	碍事
八	爱护	按期	安宁
把	爱情	暗暗	安稳
把	安全	熬	安详
爸爸	安慰	奥秘	安置
吧	安心	扒	按劳分配
白	按	把	暗淡
百	按时	把握	暗杀
摆	按照	坝	暗示
班	暗	罢	暗中
搬	岸	罢工	案
半	拔	白白	案件
半天	白	百货	案情
办	白菜	柏树	昂贵
办法	白天	摆脱	昂扬
办公室	败	拜访	凹
帮助	班长	拜会	袄
饱	板	般	芭蕾舞
抱	半导体	瓣	捌
报	半拉	半岛	疤
杯	半夜	办理	巴结
杯子	办公	帮	把柄
北	办事	绑	把关
北边	帮	棒	把手
倍	帮忙	棒	把戏
被	榜样	磅	霸道
本	傍晚	包袱	霸权
本子	包	包含	霸占
比	包	包围	掰
比较	包括	剥	白酒
比赛	包子	保管	百倍
笔	薄	保密	百分比
必须	保	保守	百花齐放
边	保持	保险	百家争鸣
变	保存	保障	摆动
变成	保护	宝	败坏
变化	保留	宝石	拜
遍	保卫	报	拜年
表	保证	报仇	斑
表示	宝贵	报酬	班机
表现	抱歉	报复	班子
表演	报到	报刊	搬运
表扬	报道/报导	报社	扳
别	报告	暴露	颁布
别的	报名	暴雨	颁发
别人	报纸	爆发	版
病	背	爆炸	扮
不	碑	悲哀	扮演
不错	悲痛	悲观	拌
不但	北部	辈	伴
不久	北方	背包	伴侣
不如	北面	背景	伴随
不同	背	背诵	伴奏
不要	背后	背心	半边天
不用	被子	被动	半截
布	本	被迫	半径
部分	本	奔	半路
擦	本来	奔跑	半数
才	本领	本人	半途而废
菜	本事	本身	半真半假
参观	本质	奔	办学
参加	笨	甭	绑架
操场	逼	比方	棒球
草	鼻子	笔试	包办
层	比例	彼此	包干儿
茶	比如	毕竟	包裹
查	笔记	闭幕	包装
差	毕业	必	雹子
常	闭	必定	保健
常常	必然	必修	保姆
长	必要	必需	保温
场	避	壁	保养
唱	避免	边疆	保重
朝	边…边…	边界	堡垒
车	编	边缘	饱和
车站	扁	编辑	饱满
城	便	编制	宝贝
城市	便条	便利	宝剑
成	遍	便于	宝库
成绩	标点	变动	抱负
吃	标准	变革	抱怨
迟到	表达	辩论	报答
抽	表面	标语	报考
出	表明	标志	报销
出发	宾馆	表情	暴动
出来	兵	别	暴风骤雨
出去	冰	别处	暴力
出现	饼干	别字	爆
出租汽车	病房	冰棍儿	爆破
除了…以外	病菌	柄	爆竹
穿	病人	丙	悲惨
船	并	饼	悲愤
窗	并	病床	悲剧
窗户	并且	病情	悲伤
床	玻璃	剥削	卑鄙
吹	伯父/伯伯	播	背面
春	伯母	播送	背叛
春天	脖子	拨	贝壳
磁带	捕	波浪	倍数
词	补	菠菜	备用
词典	补充	博士	被告
次	补课	博物馆	奔驰
从	补习	薄弱	奔腾
从…到…	不必	不安	本能
从…起	不大	不比	本钱
从前	不得不	不曾	本性
错	不得了	不对	本着
错误	不断	不够	笨蛋
打	不敢当	不顾	笨重
打算	不管	不见	笨拙
大	不过	不见得	崩溃
大概	不好意思	不禁	绷
大家	不仅	不觉	绷带
大声	不论	不可	蹦
大学	不平	不利	逼近
大夫	不然	不料	逼迫
戴	不少	不满	鼻涕
带	不是吗	不免	比分
代表	不行	不是	比价
但是	不幸	不是…而是…	比喻
当	不许	不是…就是	比重
当	不要紧	不停	笔迹
当然	不一定	不像话	笔直
刀	不住	不由得	彼
倒	布置	不在乎	碧绿
到	步	不怎么样	币
道	部	不止	闭幕式
道理	部队	不只	闭塞
得	部门	不足	弊病
得到	部长	布告	弊端
的	猜	步骤	必将
地	材料	部署	臂
得	踩	猜想	鞭策
…得很…	采	裁缝	鞭炮
得	采购	裁判	鞭子
灯	采取	才	边防
等	采用	才能	边境
等	彩色	财产	编号
低	餐厅	财富	编者按
地	藏	财政	贬低
地方	草地	餐车	贬义
第	草原	参考	贬值
弟弟	厕所	参谋	便道
点	册	蚕	变更
点	测验	残酷	变换
点	曾	惭愧	变迁
点心	曾经	惨	变形
点钟	插	灿烂	变质
电	叉子	苍白	辨别
电车	差	苍蝇	辨认
电灯	差不多	舱	辩护
电话	差点儿	仓库	辩解
电视	拆	操心	辩证
电影	产量	操纵	辫子
掉	产品	操作	辩证法
丢	产生	草案	遍地
东	尝	侧	标
东边	长期	测	标本
东西	长途	测量	标题
冬	超	测试	表彰
冬天	超过	插秧	憋
懂	抄	差别	别扭
动	抄写	茶馆	冰淇淋
动物	吵	茶话会	秉性
都	车间	茶叶	病虫害
读	彻底	铲	病毒
短	沉默	产物	病号
锻炼	趁	产值	并存
段	衬衫	颤动	并非
对	衬衣	颤抖	并列
对	称	常识	并排
对不起	称赞	长度	播放
顿	成分/成份	长久	播音
多	成功	长远	播种
多	成果	肠	拨款
多	成就	厂长	波动
多么	成立	场地	波涛
多少	成熟	场合	博览会
饿	成为	场面	薄膜
而且	成长	超额	搏斗
儿子	乘	钞票	驳斥
二	程度	潮	捕捞
发	诚恳	潮湿	捕捉
发烧	诚实	吵架	补偿
发生	承认	炒	补救
发现	吃惊	车辆	补贴
发展	尺	车厢	补助
法语/法文	翅膀	扯	卜
翻	充分	撤	不卑不亢
翻译	充满	尘土	不辞而别
反对	充足	沉	不当
饭	冲	沉思	不得
饭店	虫子	沉重	不得已
方便	重	陈列	不等
方法	重叠	撑	不定
方面	重复	称呼	不法
方向	重新	成	不妨
房间	崇高	成本	不公
访问	抽象	成千上万	不解
放	愁	成天	不堪
放假	臭	成语	不愧
非常	初	成员	不良
飞	初步	乘客	不容
飞机	初级	盛	不时
分	出版	程序	不惜
分	出口	承包	不相上下
…分之… 	出生	承担	不朽
分钟	出席	吃苦	不言而喻
丰富	出院	吃亏	不宜
封	厨房	吃力	不正之风
风	除	持久	不知不觉
夫人	处	池	不至于
服务	处分	迟	布局
服务员	处理	尺寸	步兵
辅导	处	尺子	步伐
复习	传	赤道	步行
复杂	传播	充实	步子
父亲	传统	冲击	埠
负责	闯	冲突	部件
附近	创	冲	部位
该	创造	仇	猜测
改	创作	仇恨	裁
改变	春节	丑	裁决
干净	此	初期	才干
感到	此外	初中	才智
感冒	刺	出路	财
感谢	聪明	出卖	财经
敢	从不/没	出门	财会
干	从…出发	出难题	财力
干部	从此	出身	财务
刚	从而	出事	采访
刚才	从来	出息	采集
钢笔	从事	出洋相	采纳
高	粗	出租	菜单
高兴	醋	除	餐
搞	促进	除非	参军
告诉	催	处于	参议院
哥哥	存	处处	参与
歌	存在	传达	参阅
个	寸	传染	参照
各	措施	传说	残
各种	搭	喘	残暴
给	答应	串	残疾
根	答	窗口	残忍
跟	答案	窗帘	残余
更	答卷	窗台	仓促
工厂	达到	床单	操
工人	打扮	创立	操劳
工业	打倒	创新	操练
工作	打扰	垂	槽
公共汽车	打听	垂直	草率
公斤	打针	春季	策划
公里	大胆	纯	策略
公园	大多数	纯洁	侧面
够	大会	瓷	测定
姑娘	大伙儿	词汇	测算
故事	大街	此刻	层出不穷
刮	大量	刺激	层次
挂	大陆	次	蹭
关	大米	次要	插嘴
关系	大批	伺候	叉
关心	大人	匆忙	差错
馆	大使馆	从容	差距
广播	大小	丛	差异
贵	大型	凑	查处
贵姓	大衣	粗心	查获
国	大约	粗心大意	查明
国家	呆	促使	查阅
过	呆	窜	刹那
过	代	摧毁	诧异
过来	代替	村庄	岔
过去	袋	村子	柴油
过去	待	搓	掺
哈哈	担任	挫折	搀
还	担心	错字	蝉
还是	单	答复	馋
孩子	单	达	谗言
海	单词	达成	缠
寒假	单调	打	产
喊	单位	打败	产地
汉语	但	打击	产区
汉字	淡	打架	产业
好	蛋	打交道	阐明
好	蛋糕	打量	阐述
好吃	当…的时候	打破	颤
好处	当地	打扫	昌盛
好看	当年	打仗	猖狂
好像	当前	打招呼	尝试
号	当时	大半	常规
喝	挡	大便	常见
和	党	大大	常年
合适	党员	大道	常务
河	当	大地	常用
黑	当做	大都	长处
黑板	刀子	大队	长短
很	岛	大方	长寿
红	到处	大哥	长征
后	到达	大力	偿
后边	到底	大脑	偿还
忽然	到底	大嫂	厂房
湖	倒	大使	厂家
互相	倒	大意	厂商
花	道	大致	场所
花	道	大众	敞开
画	道德	大自然	畅谈
画	道路	带儿	畅通
化学	道歉	带动	畅销
话	德语/德文	带领	倡议
坏	…的话…	带头	超产
欢迎	登	代	超出
还	登记	代办	超级
换	等	代价	超越
黄	等待	代理	朝代
回	等于	待遇	嘲笑
回	滴	逮捕	潮流
回答	敌人	耽误	吵闹
回来	的确	担	吵嘴
回去	底下	担负	车床
会	地带	单纯	撤退
会	地点	单独	撤销
会话	地方	胆	沉淀
活	地面	诞生	沉静
活	地球	蛋白质	沉闷
活动	地区	当	沉痛
火车	地图	当初	沉着
或者	地位	当代	陈旧
基本	地下	当家	陈述
基础	地址	当面	称心
机场	递	当中	称号
机会	电报	党派	城镇
机器	电冰箱	党委	成交
鸡	电风扇	档案	成品
鸡蛋	电视台	倒霉	成人
…极了…	电台	倒腾	成套
集合	电梯	岛屿	成效
急	电影院	导弹	成心
挤	店	导师	呈
几	吊	导演	呈现
技术	钓	导致	乘机
寄	调	到…为止	乘务员
计划	调查	得病	惩
记	跌	得了	惩办
继续	顶	得意	惩罚
家	顶	灯火	澄清
家庭	定	灯笼	诚心诚意
加	订	蹬	诚意
坚持	东北	等到	诚挚
间	东部	等候	承办
检查	东方	瞪	承受
简单	东面	凳子	秤
见	东南	堤	持续
见面	懂得	滴	池塘
件	动人	抵	迟缓
健康	动身	抵抗	迟疑
建设	动手	底	齿轮
将来	动物园	底片	赤字
江	动员	地板	充当
讲	动作	地步	充沛
交	冻	地道	冲锋
教	洞	地理	冲破
脚	斗争	地势	重
角	豆腐	地毯	重申
饺子	逗	地形	崇拜
教室	独立	地震	崇敬
教育	读书	地质	抽空
叫	读者	地主	抽屉
叫	堵	弟兄	踌躇
接	肚子	典礼	稠密
接着	度	典型	筹备
街	度过	电池	筹建
节	渡	电力	绸子
节目	端	电铃	丑恶
节日	短期	电流	出差
结果	断	电炉	出产
结束	堆	电脑	出动
解决	队	电器	出发点
姐姐	队伍	电线	出访
借	队长	电压	出境
介绍	对	电子	出面
斤	对比	惦记	出名
今年	对待	垫	出品
今天	对方	奠定	出入
紧	对付	雕刻	出色
紧张	对话	调动	出神
进	对面	爹	出世
进来	对象	叠	出售
进去	对于	丁	厨师
进行	吨	盯	锄
近	蹲	钉	除此之外
精彩	多数	钉子	除外
精神	夺	顶	除夕
经常	躲	顶	储备
经过	朵	定期	储藏
经济	鹅	订婚/定婚	储存
经验	而	冬季	储蓄
久	儿童	懂事	处罚
九	耳朵	动机	处方
酒	发表	动静	处境
旧	发出	动力	处决
就	发达	动摇	处置
橘子	发动	抖	触
举	发抖	陡	触犯
句	发挥	斗	川流不息
句子	发明	豆浆	传单
觉得	发言	豆子	传递
决定	发扬	毒	传授
咖啡	法郎	毒	传送
卡车	法律	独特	传真
开	繁荣	独自	船舶
开始	凡	读物	船只
开玩笑	反动	端	疮
开学	反复	端正	床铺
看	反抗	堆	床位
看病	反应	堆积	创办
看见	反映	兑换	创建
考试	反正	队员	创业
棵	范围	对得起	炊事员
科学	犯	对…来说	吹牛
咳嗽	方	对了	吹捧
可能	方案	对立	捶
可是	方式	对门	锤
可以	方针	顿时	春耕
渴	房子	哆嗦	纯粹
克	防	多半	蠢
刻	防止	多亏	磁铁
客气	仿佛	多劳多得	雌
课	纺织	多余	辞
课本	放大	夺取	辞职
课文	放弃	俄语/俄文	慈爱
空气	放心	恶心	慈祥
口	非…不可	恶	词句
口语	肥	恶化	此后
哭	肺	恶劣	此时
苦	费	儿女	次品
块	费	发电	次数
快	费用	发觉	次序
困难	吩咐	发射	刺
拉	分别	发行	葱
啦	分配	发育	匆匆
来	分析	罚	从…看来
蓝	纷纷	法令	从容不迫
篮球	粉笔	法院	从头
劳动	奋斗	法制	从未
劳驾	份	法子	从小
老	愤怒	番	从中
老师	封建	翻身	凑合
了	风景	繁殖	凑巧
累	风力	凡是	粗暴
冷	风俗	烦	粗粮
离	逢	反	粗鲁
离开	否定	反	粗细
里	否则	反而	促
里	扶	反击	摧残
里边	幅	反问	翠绿
礼物	符合	返	脆
历史	服从	犯人	脆弱
利用	浮	犯罪	存放
例如	副	饭馆	存款
立刻	副	泛滥	磋商
俩	副食	方	搭配
联系	复述	房屋	答辩
连…都/也…	复印	防守	打发
脸	付	防御	打猎
练习	富	防治	大包大揽
凉快	妇女	妨碍	大臣
两	该	纺	大多
辆	改革	放手	大公无私
亮	改进	放松	大锅饭
了	改善	放学	大局
了解	改造	放映	大理石
零	改正	非	大拇指
领导	概括	非	大炮
留	概念	飞快	大气压
留念	盖	飞行	大肆
留学生	干	飞跃	大体
流	干杯	肥料	大同小异
六	干脆	肥皂	大无畏
楼	干燥	废	大厦
路	杆	废除	大雁
录音	肝	废话	大有可为
旅行	赶	废墟	大于
绿	赶紧	沸腾	歹徒
乱	赶快	费力	带劲
妈妈	感动	分布	代号
麻烦	感激	分割	代数
马	感觉	分工	贷
马上	感情	分解	贷款
嘛	感想	分离	待业
吗	感兴趣	分裂	怠工
买	干活儿	分泌	怠慢
卖	干吗	分明	担保
满	刚刚	分散	担忧
满意	钢	分数	丹
慢	港	分子	单元
忙	高大	坟	胆量
毛	高度	粉	胆怯
帽子	高原	粉碎	胆子
没	告	分量	氮
没关系	告别	分子	担
没意思	搁	粪	担子
没有	胳膊/胳臂	丰产	淡季
每	割	丰收	淡水
妹妹	革命	封	诞辰
门	隔	封锁	弹
门口	隔壁	风格	弹药
们	个别	风气	当场
米/公尺	个人	疯	当局
米饭	个体	疯狂	当事人
面包	个子	缝	当心
面条儿	根本	讽刺	当选
民族	根据	佛教	党性
明年	跟前	夫妻	党章
明天	更加	服	党中央
名字	工程	俯	当天
母亲	工程师	腐蚀	档次
目前	工夫	腐朽	荡
拿	工会	复活节	刀刃
哪	工具	复制	叨唠
哪里	工艺品	负	捣
那	工资	负担	捣蛋
那	功夫	富有	捣乱
那个	供	富裕	倒闭
那里/那儿	供给	妇人	倒爷
那么	公费	改编	导航
那么	公共	改良	导体
那些	公开	盖子	导游
那样	公路	干旱	到来
哪	公司	干扰	到期
呐	公用电话	干涉	倒退
南	公元	甘	稻子
南边	巩固	赶忙	悼念
男	贡献	赶上	盗
难	共	感受	盗窃
呢	共产党	敢于	得不偿失
内	共同	干劲	得力
内容	狗	缸	得以
能	构成	纲领	得罪
能够	构造	岗位	灯泡
嗯	估计	港币	登陆
你	姑姑	港口	等级
你们	鼓	高潮	低级
年	鼓励	高等	低劣
年级	鼓舞	高峰	低温
年纪	鼓掌	高级	低下
年轻	古	高粱	敌
念	古代	高尚	敌对
您	古迹	高速	敌视
牛	古老	高压	笛子
牛奶	骨头	高中	的确良
农村	故乡	稿	抵达
农民	故意	告辞	抵制
农业	顾	歌唱	地铁
努力	顾客	歌剧	帝国
女	挂号	歌曲	帝国主义
女儿	拐	歌颂	递交
暖和	怪	鸽子	递增
爬	关键	革新	缔结
怕	关于	格外	掂
拍	关照	隔阂	颠倒
排球	官	个儿	颠覆
派	观察	个体户	颠簸
旁边	观点	个性	点火
跑	观众	各式各样	点名
跑步	管	各自	点燃
朋友	管理	给以	点缀
碰	冠军	根源	点子
批评	罐头	耕地	电动机
啤酒	贯彻	工地	电路
篇	光	工龄	电钮
便宜	光	工钱	电气
片	光	工序	电源
漂亮	光辉	攻	店员
票	光明	攻击	淀粉
苹果	光荣	攻克	殿
瓶	光线	功课	刁
破	广场	功劳	叼
七	广大	功能	雕塑
骑	广泛	供应	调度
起	广告	公	调换
起床	广阔	公安	碟子
起来	逛	公布	叮嘱
汽车	规定	公民	顶点
汽水	规律	公顷	顶端
铅笔	规模	公式	定点
千	鬼	公用	定额
钱	跪	宫	定价
前	滚	宫殿	定居
前边	锅	弓	定理
浅	国际	共和国	定量
墙	国民党	共青团	定律
桥	国王	钩	定向
青年	果然	钩子	定性
轻	过程	勾结	定义
清楚	过年	沟	订购/定购
晴	海关	购	订货/定货
情况	海洋	购买	订阅/定阅
请	害	辜负	钉
请假	害处	孤立	丢人
请问	害怕	鼓动	丢失
秋	含	古典	东奔西走
秋天	寒冷	骨干	东道主
球	汗	谷子	冬瓜
取得	行	股	董事
去	航空	雇	动荡
去年	毫不	顾问	动工
全	毫无	固定	动乱
全部	好好儿	固然	动脉
全体	好久	固体	动态
确实	好容易	瓜	动用
然后	好听	瓜子	冻结
让	好玩儿	寡妇	栋
热	好些	乖	兜
热情	号码	拐弯儿	兜儿
人	号召	怪	斗志
人们	好	怪	都市
人民	和平	怪不得	督促
任何	合	关	毒害
认识	合理	关怀	毒品
认为	合同	关头	毒性
认真	合作	官僚主义	独
日	盒	观测	独裁
日语/日文	嘿	观看	独立自主
日子	黑暗	观念	堵塞
容易	恨	管道	赌
肉	哼	管子	赌博
三	红茶	罐	杜绝
散步	红旗	惯	镀
山	猴子	灌	渡船
商店	厚	灌溉	渡口
上	后悔	光	短处
上	后来	光彩	短促
上边	后面	光滑	短暂
上课	后年	光临	缎子
上来	后天	广	断定
上去	呼	规划	断断续续
上午	呼吸	规矩	断绝
上学	壶	规则	兑现
少	胡乱	归	对岸
社会	胡子	轨道	对策
身体	糊涂	柜台	对称
深	护士	柜子	对抗
什么	护照	贵宾	对联
声	户	棍子	对手
声调	花园	锅炉	对头
声音	划	国防	对应
生产	滑	国籍	对照
生词	滑冰	国旗	夺得
生活	画报	国庆节	躲避
生日	划	国务院	躲藏
省	化	国营	跺
剩	坏处	果实	舵
胜利	欢送	果树	堕落
师傅	环	裹	蛾子
十	环境	过	额
十分	慌	过渡	额外
时候	黄瓜	过分	讹
时间	黄油	咳	恶毒
食堂	皇帝	海拔	恶性
实践	灰	海军	恩
实现	挥	海面	恩爱
使用	恢复	海峡	恩情
世界	回头	害虫	恩人
事	回信	含糊	而后
事情	回忆	含量	而已
是	会场	喊叫	二氧化碳
市	会见	旱	贰
试	会客	焊	发病
收	会谈	行	发布
收拾	会议	行列	发财
手	昏迷	行业	发愁
手表	婚姻	航行	发奋图强
首都	混	毫米	发火
输	活泼	好	发脾气
舒服	活跃	好比	发票
书	伙食	耗	发起
熟	火	好奇	发热
数	火柴	呵	发誓
树	获得	核	发炎
数学	或	何必	发扬光大
双	货	何况	伐
谁	几乎	合唱	罚款
水	机床	合成	法
水果	机关	合法	法定
水平	机械	合格	法官
睡	积极	合金	法规
睡觉	积极性	合算	法人
说	积累	河流	法庭
说明	激动	黑夜	法西斯
思想	激烈	痕迹	法则
死	极	狠	帆
四	极其	恨不得	帆船
送	集	横	番茄
宿舍	集体	宏伟	繁
酸	集中	洪水	繁多
算	及	喉咙	繁华
虽然	及格	吼	繁忙
岁	及时	后代	繁体字
所以	急忙	后方	繁重
所有	即	后果	烦闷
他	级	后头	烦恼
他们	技术员	后退	烦躁
它	季节	呼呼	反驳
它们	计算	忽视	反常
她	记得	胡说	反倒
她们	记录	胡同	反感
抬	记忆	蝴蝶	反革命
太	记者	护	反攻
太阳	既	互助	反馈
态度	既…也…	花朵	反面
谈	既…又…	花生	反射
汤	既然	哗哗	反思
糖	纪律	华侨	反之
躺	纪念	华人	返回
讨论	夹	滑雪	贩卖
特别	家具	画家	范畴
疼	家乡	画蛇添足	犯法
踢	加工	化工	犯浑
提	加强	化合	饭碗
提高	加以	化石	泛
体育	假	化验	方程
天	价格	话剧	房东
天气	价值	怀	房租
条	架	怀念	防护
条件	假条	怀疑	防线
跳	坚定	坏蛋	防汛
跳舞	坚决	欢呼	防疫
听	坚强	欢乐	放射
听见	尖	欢喜	非…才
听说	尖锐	缓和	非法
听写	肩	缓缓	飞船
停	艰巨	缓慢	飞舞
挺	艰苦	患	飞翔
通	拣	幻灯	肥沃
通过	捡	幻想	匪徒
通知	剪	唤	诽谤
同时	减	荒	废品
同学	减轻	慌忙	废气
同意	减少	黄昏	废物
同志	箭	黄色	分辩
痛快	渐渐	晃	分辨
头	建	灰	分寸
突然	建立	灰尘	分队
图书馆	建议	灰心	分红
团结	建筑	辉煌	分化
推	将	回想	分类
腿	将	毁	分母
退	将要	汇	分批
脱	奖	汇报	分期
袜子	奖学金	汇款	分歧
外	讲话	昏	分清
外边	讲座	浑身	芬芳
外国	酱油	混合	坟墓
外语/外文	降	混乱	粉末
完	降低	混凝土	分外
完成	交换	混淆	奋勇
完全	交际	活	奋战
玩	交流	活该	愤恨
碗	交通	伙	丰满
晚	郊区	伙伴	封闭
晚饭	骄傲	火箭	蜂
晚会	角	火力	蜂蜜
晚上	教材	火焰	锋利
万	教师	火药	风暴
往	教授	获	风度
往	教学	或多或少	风光
忘	教训	货币	风浪
危险	教员	货物	风趣
为	较	基层	风沙
伟大	叫做	基地	风尚
喂	接触	机	风味
位	接待	机动	风险
为	接到	机构	风筝
为了	接见	肌肉	疯子
为什么	接近	饥饿	缝
文化	接受	激素	奉献
文学	街道	极端	奉行
文学家	阶段	集团	凤凰
文艺	阶级	急躁	否
文章	结实	疾病	否决
问	节省	即将	否认
问好	节约	即使	夫妇
问题	结构	级别	敷衍
我	结合	给予	伏
我们	结婚	技能	辐射
握手	结论	技巧	幅度
屋子	解	季	符号
五	解答	寂寞	俘虏
午饭	解放	计	服气
物理	解释	计算机	服装
西	届	记载	浮雕
西边	金	继承	浮动
希望	金属	夹子	福
习惯	今后	佳	福利
喜欢	仅	家伙	福气
洗	仅仅	家属	抚养
洗澡	尽	加紧	抚育
系	尽管	加入	辅助
细	尽量	加速	斧子
下	进步	加油	腐败
下	进攻	甲	腐化
下	进化	假如	腐烂
下边	进口	假若	赴
下课	进入	假使	副业
下来	进修	价	副作用
下去	进一步	价钱	覆盖
下午	禁止	架	赋予
夏	近来	架子	复
夏天	尽	驾驶	复辟
先	劲	假	复合
先生	京剧/京戏	假期	复活
现代	精力	嫁	复兴
现在	经	歼灭	付出
相信	经理	监督	付款
香	经历	监视	腹
香蕉	井	监狱	负伤
想	警察	坚固	富强
响	静	坚硬	富余
像	敬爱	尖子	附带
向	敬礼	煎	附和
消息	镜子	兼	附加
小	竞赛	艰难	附属
小孩儿	究竟	检讨	改建
小姐	纠正	检验	改邪归正
小时	救	碱	改组
笑	就	简便	概况
些	就是	简直	钙
鞋	局长	鉴定	干预
写	举行	贱	甘心
谢谢	拒绝	见解	甘蔗
辛苦	据说	健全	竿
新	巨大	渐	肝炎
新年	具备	溅	秆
新闻	具体	建造	感
心	具有	僵	感化
信	距离	将军	感慨
信封	距离	奖金	感染
星期	俱乐部	奖励	干线
星期日/星期天	剧场	讲究	钢材
行	卷	讲课	钢琴
幸福	觉悟	讲义	纲
姓	决	酱	纲要
休息	决心	焦急	杠杆
需要	绝对	胶卷	高产
许多	军	交代	高超
学	军队	交谈	高档
学生	军事	交易	高低
学习	开放	浇	高贵
学校	开会	搅	高考
学院	开课	脚步	高空
雪	开明	狡猾	高明
呀	开辟	角度	高烧
呀	开演	角落	高温
研究	开展	教导	高血压
颜色	砍	教练	高涨
眼睛	看不起	教堂	搞鬼
演出	看法	教研室	搞活
宴会	看来	觉	稿件
羊	看样子	揭	稿纸
样子	扛	揭露	稿子
要求	考	接连	告诫
药	考虑	阶层	告状
要	烤	结	歌手
要是	靠	截	歌星
也	颗	节	歌咏
也许	科	竭力	疙瘩
页	科学家	洁白	格
夜	科学院	结	格格不入
一	科研	结果	格局
一般	科长	解放军	格式
一边…一边…	可	解剖	隔绝
一点儿	可爱	界线	隔离
一定	可靠	借口	各奔前程
一共	可怜	金鱼	各别
一会儿	可怕	今日	各行各业
一…就…	可以	紧急	各界
一块儿	克服	紧密	根据地
一起	刻	紧俏	根深蒂固
一切	刻苦	谨慎	跟随
一下	客人	进军	跟头
一些	课程	近代	跟踪
一样	肯	浸	耕
一直	肯定	尽力	耕种
医生	空	惊	更改
医院	空间	惊动	更换
衣服	空前	惊奇	更新
椅子	空中	惊人	更正
已经	孔	惊讶	梗
以后	恐怕	惊异	工
以前	空儿	精	工具书
以为	控制	精神	工人阶级
艺术	口袋	精细	工事
亿	口号	精致	攻读
意见	扣	鲸鱼	攻关
意思	裤子	经费	功
意义	跨	经营	功绩
因为	筷子	警告	功效
音乐	快乐	警惕	恭敬
阴	宽	景色	供不应求
银行	款	景物	供销
英语/英文	矿	景象	公报
应该	捆	境	公尺
赢	困	敬酒	公道
影响	扩大	竟	公分
永远	垃圾	竟然	公告
用	来	竞争	公关
尤其	来	净	公平
邮局	来不及	净	公然
邮票	来得及	揪	公认
游泳	来信	酒店	公社
有	来自	舅舅	公务
有的	拦	舅母	公有
有名	懒	就	公有制
有时候	烂	就是说	公约
有些	狼	就是…也…	公债
有意思	朗读	居民	公证
友好	浪	居然	汞
友谊	浪费	居住	拱
右	捞	局	共产主义
又	老(是)	局部	共计
鱼	老百姓	局面	共鸣
愉快	老板	举办	共性
雨	老大妈/大妈	聚	勾
语法	老大娘/大娘	聚集	沟通
语言	老大爷/大爷	聚精会神	构思
遇到	老虎	据	构想
预习	老人	距	购买力
元	老实	剧	孤单
原来	老太太	剧烈	孤独
原谅	老头儿	剧院	姑且
圆	乐观	卷	鼓
远	雷	觉	鼓吹
愿意	类	决口	古怪
月	厘米	决议	古人
月亮	梨	绝	古文
月球	离婚	均	骨
云	理发	均匀	骨肉
运动	理解	军备	股东
再	理论	军官	股份
再见	理想	军舰	股票
在	理由	军人	雇佣
在	里面	开办	雇员
咱	礼拜天/礼拜日	开除	故
咱们	礼貌	开动	故障
脏	礼堂	开发	顾不得
早	利害/厉害	开饭	顾虑
早晨/早上	利益	开口	顾全大局
早饭	例	开幕	固有
怎么	例子	开设	固执
怎么样	立	开水	瓜分
怎样	立场	开夜车	挂钩
增加	立方	刊物	挂念
展览	立即	看	棺材
占	粒	抗议	关闭
站	力	考察	关节炎
站	力量	考验	关切
张	力气	靠近	官方
长	力所能及	科技	官僚
掌握	联合	科普	官员
着急	联欢	壳	观
找	连	可不是	观光
照顾	连忙	可见	观赏
照相	连续	可巧	管辖
这	恋爱	可惜	惯例
这个	练	可笑	惯用语
这里/这儿	粮食	可行	灌木
这么	凉	渴望	光棍儿
这些	量	客	光亮
这样	良好	客观	光芒
着	两	客厅	规范
真	聊	课堂	规格
真正	聊天儿	坑	规章
整齐	了不起	空军	硅
正	列	恐怖	龟
正确	临	空	归根到底
正在	临时	口气	归还
政府	邻居	口试	归结
政治	零钱	口头	归纳
只	铃	枯	闺女
支	灵活	窟窿	鬼子
知道	领	夸	桂冠
知识	领袖	垮	贵重
…之间…	另	快餐	贵族
指	另外	快活	滚动
只	流利	宽阔	国产
只好	龙	款待	国法
纸	楼梯	筐	国会
中	漏	狂	国际法
中间	露	狂风	国际主义
中文	路上	矿石	国库券
中午	路线	况且	国力
中学	录	昆虫	国民
钟	录像	阔	国情
钟头	录音机	喇叭	国土
种	陆续	蜡烛	国有
重	旅馆	辣	果断
重要	旅客	辣椒	过度
周	旅途	来宾	过后
周围	略	来回	过滤
猪	轮船	来客	过失
主要	论文	来往	过问
主意	萝卜	来源	过于
住	落	篮子	海岸
注意	落后	朗诵	海滨
祝	码头	牢	海港
装	马虎	牢固	海外
准备	马克	牢骚	害羞
桌子	马路	老年	含义/涵义
自己	骂	老婆	含有
自行车	埋	老人家	寒
字	买卖	老乡	寒暄
总(是)	迈	姥姥	函授
走	馒头	乐	罕见
足球	满足	类似	捍卫
祖国	猫	类型	旱灾
组织	毛	冷静	汉奸
嘴	毛病	冷却	汉学
最	毛巾	冷饮	航班
最初	毛衣	愣	航道
最后	矛盾	黎明	航海
最近	冒	理	航天
昨天	贸易	理	航线
左	煤	里头	航运
做	煤气	礼	豪华
作	没错	礼拜	好多
作业	没什么	历年	好感
坐	没事儿	利	好坏
座	没用	利润	好说
	每	力求	好样的
	美	力争	好在
	美好	联络	好转
	美丽	联盟	耗费
	美术	连接	号称
	美元	脸色	浩浩荡荡
	梦	炼	好客
	米	凉水	荷花
	秘密	两旁	核桃
	蜜蜂	量	核武器
	密	谅解	核心
	密切	料	和蔼
	棉花	列车	和解
	棉衣	裂	和睦
	面	烈士	和平共处
	面	猎人	和气
	面积	淋	和尚
	面貌	零件	和谐
	面前	灵魂	和约
	描写	领会	何
	秒	领土	何等
	庙	领域	合并
	妙	令	合乎
	灭	溜	合伙
	民主	留学	合情合理
	明亮	流传	合营
	明确	流动	合资
	明显	流氓	禾苗
	名	流水	河道
	名胜	流行	贺词
	命令	流域	黑白
	命运	柳树	狠毒
	摸	笼子	狠心
	模仿	拢	恒星
	磨	垄断	横行
	墨水儿	笼罩	横
	某	楼道	轰动
	模样	楼房	轰轰烈烈
	亩	搂	轰炸
	母	露面	烘
	木	喽	虹
	木头	炉子	宏大
	目标	路过	红领巾
	目的	路口	哄
	哪个	露	哄
	哪怕	陆地	厚度
	哪些	陆军	候补
	那边	驴	候选人
	奶奶	铝	后期
	耐心	旅游	后勤
	耐用	卵	后台
	南部	掠夺	呼声
	南方	轮廓	呼啸
	南面	轮流	呼吁
	男人	轮子	忽略
	难道	论	葫芦
	难过	逻辑	胡
	难看	锣	胡来
	难受	骆驼	糊
	脑袋	马克思主义	狐狸
	脑子	瞒	互利
	闹	满腔	户口
	内部	漫长	花费
	能干	盲目	花色
	能力	毛笔	花纹
	能源	毛线	花样
	泥	毛泽东思想	华丽
	年代	茅台酒	画面
	年龄	梅花	划分
	年青	没说的	化肥
	鸟	眉毛	化纤
	扭	眉头	化妆
	浓	美观	话题
	弄	闷	槐树
	女人	门诊	怀孕
	女士	闷	欢笑
	暖	蒙	环节
	暖气	猛	还原
	怕	猛烈	缓
	排	猛然	换取
	排	梦想	患者
	牌	眯	荒地
	盘	迷	荒凉
	盘子	迷糊	荒谬
	盼望	迷信	荒唐
	判断	谜语	慌乱
	旁	秘书	慌张
	胖	蜜	黄金
	炮	免得	皇后
	赔	勉强	蝗虫
	陪	面对	晃
	配合	面粉	挥霍
	喷	面孔	回避
	盆	面临	回顾
	捧	苗	回击
	碰见	灭亡	回收
	批	民兵	毁坏
	批判	民间	毁灭
	批准	民用	悔
	披	敏捷	悔改
	脾气	明白	悔恨
	疲劳	明明	贿赂
	皮	明信片	会同
	皮肤	鸣	会晤
	匹	命	会员
	偏	模范	汇集
	片面	模糊	汇率
	骗	模型	绘
	飘	摩托车	绘画
	拼命	抹	混纺
	品种	末	混合物
	乒乓球	墨	混浊
	平	陌生	豁
	平安	某些	活力
	平常	墓	伙计
	平等	幕	火山
	平方	木材	火灾
	平静	目光	获取
	平均	牧场	或是
	平时	牧民	或许
	平原	拿…来说	祸
	瓶子	奶	祸害
	坡	耐	击
	破坏	耐烦	基督教
	迫切	男子	基金
	扑	难得	机车
	铺	难怪	机灵
	朴素	难题	机密
	普遍	难以	机枪
	普通	脑筋	机体
	期	脑力	机遇
	期间	闹笑话	机智
	欺骗	闹着玩儿	积
	妻子	内科	积压
	其次	嫩	激
	其他	能	激发
	其它	能	激光
	其余	能歌善舞	激励
	其中	能量	激情
	奇怪	泥土	讥笑
	齐	念书	吉普车
	旗子	娘	吉祥
	企图	捏	极度
	企业	拧	极力
	启发	宁可	极限
	气	扭转	籍贯
	气候	农场	集会
	气温	农具	集市
	气象	农贸市场	集邮
	汽油	农田	集资
	牵	农药	及早
	千万	农作物	急剧
	签订	奴隶	急切
	前进	怒	急需
	前面	女子	急于
	前年	噢	即使
	前天	哦	嫉妒
	前途	偶尔	脊梁
	欠	偶然	几何
	枪	趴	迹象
	强	拍摄	季度
	强大	拍子	寄托
	强盗	排斥	寂静
	强调	排列	计较
	强度	牌子	记号
	强烈	攀	记性
	抢	攀登	记忆力
	敲	盘	忌
	悄悄	盼	继
	桥梁	畔	纪要
	瞧	抛	嘉奖
	巧	炮弹	夹杂
	巧妙	泡	家常
	切	培养	家畜
	且	培育	家务
	侵略	赔偿	家喻户晓
	亲爱	陪同	家长
	亲戚	配	加班
	亲切	佩服	加急
	亲自	盆地	加剧
	青	蓬勃	加热
	轻松	棚	加深
	清	膨胀	加重
	情景	碰钉子	颊
	情形	批	甲板
	情绪	疲倦	假定
	请客	屁股	假冒
	请求	譬如	假设
	庆祝	偏	假装
	穷	偏偏	驾
	球场	飘扬	监察
	求	拼	坚韧
	区	贫苦	坚实
	区别	贫穷	坚信
	渠	品德	坚贞不屈
	取	品质	尖端
	取消	平凡	兼任
	圈	平衡	肩膀
	全面	平行	艰险
	劝	凭	奸
	缺	评	茧
	缺点	评价	检测
	缺乏	评论	检察
	缺少	泼	检举
	却	破产	检修
	确定	破烂	简称
	裙子	迫害	简短
	群	葡萄	简化
	群众	普及	简陋
	然而	普通话	简明
	燃烧	欺负	简体字
	染	漆	简要
	嚷	其	简易
	绕	其实	剪彩
	惹	棋	剪刀
	热爱	奇迹	减产
	热烈	旗袍	减低
	热闹	旗帜	减弱
	热水瓶/暖水瓶	起初	间隔
	热心	起飞	间接
	人才/人材	起义	鉴别
	人工	起源	鉴于
	人家	器材	践踏
	人口	器官	见识
	人类	气	见效
	人民币	气氛	键盘
	人物	气愤	健美
	人员	气概	健壮
	人造	气体	建交
	忍	气味	姜
	任务	气压	将近
	认	汽船	桨
	认得	恰当	奖品
	扔	恰好	奖状
	仍	恰恰	讲解
	仍然	铅	讲理
	日常	千方百计	讲述
	日程	千克	讲演
	日记	谦虚	降价
	日期	前方	降临
	日用品	前后	降落
	日元	前头	焦点
	如	歉意	焦炭
	如	墙壁	胶
	如果	强迫	胶片
	如何	翘	交叉
	如今	切实	交错
	入	侵犯	交点
	软	侵入	交付
	弱	亲	交涉
	撒	亲热	交手
	洒	亲人	交替
	赛	亲眼	交往
	伞	琴	浇灌
	噪子	勤劳	娇
	扫	青菜	娇气
	嫂子	青春	嚼
	色	青蛙	搅拌
	森林	轻视	绞
	杀	轻易	缴
	沙发	倾向	缴纳
	沙漠	清晨	教会
	沙子	清除	教唆
	傻	清洁	教条
	晒	清晰	教养
	山脉	清醒	轿车
	山区	晴天	较量
	闪	情	叫喊
	善于	情报	叫唤
	伤	请教	叫嚷
	伤心	请示	揭发
	商场	穷人	揭示
	商量	秋季	接班
	商品	丘陵	接二连三
	商业	区域	接洽
	上班	曲折	接收
	上当	渠道	皆
	上级	娶	街坊
	上面	趣味	街头
	上衣	圈子	结果
	稍	权利	截止
	稍微	权力	劫
	烧	全局	劫持
	勺子	拳头	节能
	少数	劝告	节育
	少年	群岛	节奏
	蛇	燃料	杰出
	舌头	染料	杰作
	射	饶	结晶
	设备	热带	结局
	设计	热量	结算
	伸	人家	结业
	身	人间	解除
	身边	人力	解雇
	深厚	人群	解散
	深刻	人士	戒严
	深入	人体	界
	什么的	人心	界限
	神	忍不住	借鉴
	神经	忍耐	借助
	生	忍受	金额
	生	任	金黄
	生动	任	金牌
	生命	任性	金钱
	生气	任意	金融
	生物	仍旧	筋
	生意	日报	津津有味
	生长	日夜	津贴
	升	日益	紧迫
	绳子	日用	紧缩
	省	荣幸	锦绣
	胜	溶液	尽快
	失败	容	进程
	失去	容器	进而
	失望	容许	进取
	失业	揉	进展
	狮子	柔软	晋升
	施工	如此	禁
	湿	如同	禁区
	诗	如下	近年
	石头	软弱	近期
	石油	若	近视
	拾	若干	近似
	时代	塞	劲头
	时刻	散	惊慌
	时期	散文	精打细算
	食品	散	精华
	食物	散布	精简
	实际	丧失	精美
	实事求是	色彩	精密
	实行	纱	精确
	实验	删	精通
	实用	山地	精心
	实在	山峰	精益求精
	使	山谷	兢兢业业
	始终	闪电	经典
	世纪	闪烁	经商
	事件	扇子	经受
	事实	伤害	经销
	事物	伤口	茎
	事先	伤脑筋	警戒
	事业	商人	警卫
	适当	上帝	景
	适合	上升	颈
	适应	上述	静悄悄
	适用	上头	境地
	市场	上下	境界
	室	上旬	敬
	试卷	上游	敬而远之
	试验	少女	镜头
	收获	少先队	竞选
	收入	哨兵	净化
	收音机	舍不得	纠纷
	手段	舍得	玖
	手工	摄氏	酒会
	手绢/手帕	摄影	酒精
	手术	射击	救济
	手套	社会主义	救灾
	手续	社论	就餐
	手指	设	就地
	首	设法	就近
	首先	设想	就算
	受	申请	就业
	瘦	身材	就职
	蔬菜	身份/身分	鞠躬
	叔叔	身子	拘留
	舒适	深度	拘束
	书包	深夜	居
	书店	神话	居室
	书记	神秘	菊花
	书架	神气	局势
	熟练	神情	局限
	熟悉	神圣	举动
	暑假	审查	举世闻名
	属于	婶子	举世瞩目
	树林	甚至	聚会
	数	甚至于	拒
	数量	慎重	据点
	数字	声明	据悉
	刷	生	具
	摔	生病	锯
	甩	生存	剧本
	率领	生理	剧团
	双方	省得	捐
	水稻	省长	捐款
	水泥	圣诞节	捐献
	顺	剩余	捐赠
	顺便	师范	圈
	顺利	失掉	掘
	撕	失眠	觉察
	私	湿润	觉醒
	私人	诗人	决不
	司机	时常	决策
	丝	时机	决赛
	似乎	时节	决算
	松	时时	决战
	送行	实话	绝望
	速度	实况	绝缘
	塑料	实施	菌
	算了	实习	军阀
	随	实质	军医
	随便	使得	军用
	随时	使劲	军装
	碎	驶	君
	损失	示威	俊
	缩	士兵	卡
	所	似的	卡片
	所	事故	开采
	所谓	事迹	开刀
	塔	事务	开工
	台	逝世	开关
	太太	势力	开化
	谈话	是的	开垦
	谈判	是非	开阔
	弹	是否	开朗
	毯子	适宜	开天辟地
	探	市长	开头
	趟	收割	开拓
	烫	收集	开心
	掏	收缩	开支
	逃	手枪	凯旋
	讨厌	手势	刊登
	套	守	勘探
	特此	寿命	看待
	特点	售	看起来
	特殊	售货	看望
	提倡	梳	看做
	提供	梳子	慷慨
	提前	舒畅	糠
	题	书本	抗旱
	题目	书籍	抗击
	体会	树立	抗战
	体积	树木	炕
	体系	束	考古
	体育场	束缚	考核
	体育馆	数据	考取
	替	数目	磕
	天真	刷子	颗粒
	添	耍	科目
	填	衰弱	可歌可泣
	田	拴	可观
	田野	霜	可贵
	甜	双	可口
	挑	水分	可恶
	条约	水库	可喜
	调整	水利	可想而知
	贴	水力	客车
	铁	睡眠	课时
	铁路	税	课题
	听讲	顺	啃
	停止	顺手	恳切
	通讯	说不定	恳求
	同	说法	空洞
	同	说服	空话
	同情	思考	空调
	同屋	思念	空想
	同样	思索	空心
	铜	思维	空虚
	桶	私有	恐惧
	统一	司令	孔雀
	统治	丝毫	空白
	痛	死	空隙
	痛苦	死亡	控诉
	偷	四处	抠
	偷偷	四面八方	口岸
	投	四周	口腔
	投入	饲养	枯燥
	头	松树	苦难
	头发	送礼	苦恼
	透	搜集	库
	突出	艘	库存
	突击	俗话	库房
	图	速成	夸奖
	涂	算是	挎
	土	算数	快速
	土地	虽	会计
	土豆	虽说	宽敞
	吐	随后	宽大
	吐	随即	宽广
	兔子	随手	狂妄
	团	岁数	框
	推动	孙女	矿藏
	推广	孙子	矿产
	拖	损害	矿井
	托	损坏	矿区
	脱离	缩短	矿山
	挖	缩小	矿物
	哇	锁	旷工
	歪	锁	旷课
	外地	所在	亏
	外交	塌	亏待
	外面	踏实	亏损
	弯	踏	葵花
	完整	摊	困苦
	网球	摊	扩充
	往往	滩	扩建
	望	谈话	扩散
	忘记	谈论	扩展
	微笑	坦克	扩张
	危害	探索	腊月
	危机	叹气	落
	违反	倘若	来访
	围	桃	来回来去
	围绕	逃避	…来看/…来讲
	维护	特	来历
	委员	特务	来临
	尾巴	特征	来年
	未	提包	来说
	未来	提纲	赖
	味道	提问	兰花
	胃	提醒	栏杆
	喂	提议	懒惰
	位置	蹄	狼狈
	卫生	体操	浪潮
	卫星	体力	浪漫
	温度	体面	劳动力
	温暖	体温	牢房
	文件	体现	牢记
	文明	天才	老成
	文物	天空	老汉
	文字	天然	老化
	闻	天然气	老家
	稳	天上	老鼠
	稳定	天文	老太婆
	问候	天下	老天爷
	握	天主教	老爷
	污染	田地	老一辈
	屋	挑选	涝
	无	条例	乐趣
	无论	调节	乐意
	无数	调皮	勒
	无限	跳动	雷达
	武器	厅	雷雨
	武术	停留	垒
	雾	亭子	棱
	物价	挺	冷淡
	物质	通常	犁
	误会	通顺	离别
	西北	通信	离休
	西部	同伴	篱笆
	西餐	同胞	理睬
	西方	同盟	理会
	西瓜	筒	理事
	西红柿	统计	理所当然
	西南	统统	理直气壮
	西面	投机	礼节
	吸	投降	礼品
	吸收	头脑	荔枝
	吸烟/抽烟	透明	栗子
	吸引	突破	历代
	牺牲	图画	历来
	洗衣机	徒弟	利弊
	系统	途径	利害
	戏	土	利息
	细菌	土壤	例外
	细心	团体	立方米
	下班	团员	立交桥
	下面	团长	立体
	吓	推迟	沥青
	掀	推辞	力图
	先后	推翻	联
	先进	推荐	联邦
	鲜	推进	联想
	鲜花	退步	连…带…
	纤维	退休	连队
	闲	吞	连滚带爬
	显得	拖拉机	连连
	显然	托儿所	连绵
	显著	驮	连年
	现代化	妥当	连同
	现实	娃娃	连续剧
	现象	瓦	连夜
	献	歪曲	莲子
	县	外部	廉价
	羡慕	外界	廉洁
	限制	外科	廉政
	线	外头	帘
	相	外衣	镰刀
	相当	外祖父	脸盆
	相反	外祖母	恋
	相互	弯曲	练兵
	相似	玩笑	链子
	相同	玩意儿	梁
	香肠	顽固	良
	香皂	顽强	良种
	箱子	丸	良心
	乡	完备	两极
	乡下	完善	两口子
	详细	挽	两手
	想法	挽救	晾
	想念	晚报	亮光
	想像/想象	万分	疗效
	响应	万古长青	疗养
	享受	万岁	辽阔
	项	万万	潦草
	项目	万一	列举
	象	网	列入
	消费	往来	列席
	消化	威胁	烈火
	消灭	微小	劣
	消失	违背	林场
	晓得	围巾	林区
	小伙子	为难	林业
	小麦	为首	磷
	小朋友	为止	临床
	小说	维持	临近
	小心	维生素	邻
	小学	委屈	邻国
	校长	委托	零售
	笑话	未必	零碎
	效果	味	零星
	效率	位于	玲珑
	歇	慰问	伶俐
	斜	温	凌晨
	血	温带	灵
	新鲜	温和	灵敏
	心得	蚊子	灵巧
	心情	闻名	岭
	心脏	吻	领事
	信	嗡	领先
	信心	卧	领子
	星星	污	硫酸
	兴奋	诬蔑	留恋
	形成	无比	留神
	形容	无产阶级	留心
	形式	无法	留意
	形势	无可奈何	流寇
	形象	无论如何	流浪
	形状	无情	流露
	行	无所谓	流通
	行动	无线电	陆
	行李	无疑	龙头
	醒	武装	聋
	兴趣	舞蹈	隆重
	性	舞会	漏税
	性格	舞台	路程
	性质	侮辱	路面
	姓名	物品	路子
	兄弟	物体	鹿
	胸	物资	录取
	雄	误	录用
	雄伟	西服	陆
	熊猫	西医	旅
	修	吸取	旅店
	修改	稀	旅游业
	修理	锡	履行
	虚心	袭击	屡次
	许	媳妇	律师
	宣布	喜爱	率
	宣传	喜悦	绿化
	选	戏剧	乱七八糟
	选举	细胞	略微
	选择	细致	抡
	学	瞎	论点
	学费	虾	论述
	学期	峡谷	论证
	学术	下降	啰唆
	学问	下列	螺丝钉
	血液	下旬	骡子
	寻找	下游	罗列
	训练	夏季	箩筐
	迅速	鲜明	落成
	压	鲜血	落地
	压迫	鲜艳	落实
	牙	咸	落选
	牙刷	闲话	抹布
	盐	嫌	麻
	严格	显示	麻痹
	严肃	险	麻袋
	严重	现	麻木
	研究所	现成	麻雀
	延长	县城	麻醉
	沿	宪法	蚂蚁
	眼	陷	马车
	眼镜	线路	马达
	眼泪	相对	马力
	眼前	香烟	马铃薯
	演	箱	马戏
	演员	乡村	埋没
	咽	响亮	埋头
	阳光	巷	卖国
	仰	相声	脉搏
	养	向导	埋怨
	样	向来	满怀
	邀请	象征	满月
	腰	削	慢性
	摇	消除	蔓延
	咬	消毒	茫茫
	要紧	消耗	茫然
	爷爷	消极	盲从
	业务	小便	盲人
	业余	小组	忙碌
	叶子	笑容	茂密
	夜里	协定	茂盛
	夜晚	协会	冒进
	一	协助	冒牌
	一半	协作	冒险
	一边	写作	玫瑰
	一…也…	卸	枚
	一方面…一方面…	欣赏	酶
	一齐	辛勤	霉
	一生	新生	没吃没穿
	一时	新式	没辙
	一同	新型	媒介
	一下子	心爱	镁
	一致	心理	美德
	一道	心事	美满
	医务室	心思	美妙
	医学	心意	美中不足
	依靠	信号	门当户对
	移	信念	门市部
	移动	信任	萌芽
	仪器	信息	迷惑
	疑问	形态	迷失
	已	行人	弥补
	以	行驶	弥漫
	以及	行为	密度
	以来	行星	密封
	以内	行政	棉
	以上	兴高采烈	免
	以外	幸亏	免除
	以下	性别	免费
	意外	性能	勉励
	意志	凶	面包车
	议论	凶恶	面面俱到
	异常	修建	面目
	因此	修正	面容
	因而	修筑	面子
	因素	锈	描
	银	绣	描绘
	引起	需	描述
	印	须	渺小
	印刷	叙述	蔑视
	印象	宣告	民航
	英雄	宣言	民事
	英勇	悬	民意
	应	悬崖	民众
	应当	旋转	敏感
	营养	选修	敏锐
	营业	学会	明星
	迎接	学科	名称
	影子	学年	名次
	应用	学时	名单
	硬	学说	名额
	拥抱	学位	名副其实
	拥护	学员	名贵
	勇敢	学者	名牌
	勇气	学制	名人
	用不着	雪花	名声
	用处	血管	名义
	用功	血汗	名誉
	用力	循环	命名
	优点	询问	命题
	优良	寻	谬论
	优美	压力	摸索
	优秀	压缩	蘑菇
	悠久	压制	模式
	由	押	膜
	由于	鸭子	磨擦
	油	芽	魔鬼
	游览	牙齿	魔术
	游泳池	牙膏	抹杀
	有的是	亚军	莫
	有(一)点儿	烟	莫名其妙
	有关	烟囱	默默
	有利	淹	谋
	有力	严	谋求
	有趣	严禁	木匠
	有时	严厉	目
	有效	严密	目睹
	有用	研究生	目录
	右边	研制	目中无人
	于	岩石	牧区
	于是	沿儿	牧业
	雨衣	沿海	穆斯林
	与	掩盖	那时
	语调	掩护	纳闷儿
	语气	眼光	纳税
	语音	眼看	乃
	羽毛球	演说	奶粉
	玉米	燕子	耐力
	遇	厌恶	男性
	遇见	扬	难度
	预备	洋	难关
	员	氧化	难堪
	原料	氧气	难免
	原因	养成	难
	原则	养料	难民
	圆珠笔	摇摆	恼火
	愿望	摇晃	闹事
	院	遥远	内地
	院长	窑	内阁
	院子	谣言	内行
	约	药方	内幕
	约会	药品	内心
	越…越…	药水儿	内在
	越来越…	药物	内脏
	阅读	要	内战
	阅览室	要不	内政
	允许	要不然	能手
	运	要不是	尼龙
	运动会	要点	拟
	运动员	要好	拟定
	运输	钥匙	逆流
	运用	野兽	年度
	杂	冶金	年头儿
	杂技	夜间	捻
	灾	液体	撵
	灾害	一带	念头
	暂时	一一	酿
	赞成	一口气	尿
	遭到	一连	捏造
	遭受	一路平安	柠檬
	糟糕	一路顺风	凝固
	造	一面…一面	凝结
	造句	一旁	凝视
	责任	一系列	宁静
	则	一下	宁肯
	增长	一向	宁愿
	扎	一心	纽扣儿
	摘	一行	浓度
	窄	一阵	浓厚
	粘	一再	农产品
	展出	医疗	农户
	展开	依旧	弄虚作假
	展览会	依据	奴役
	战斗	依然	怒吼
	战胜	依照	怒火
	战士	伊斯兰教	女性
	战争	遗产	挪
	章	遗憾	殴打
	涨	遗留	呕吐
	丈	仪表	扒
	丈夫	仪式	拍照
	招待	疑心	排除
	招待会	姨	排队
	招呼	倚	排挤
	着	乙	排长
	照	以便	徘徊
	照常	以至	派别
	照片/相片	以致	派出所
	召开	抑制	派遣
	折	易	盘旋
	哲学	意识	判处
	这边	意味着	判定
	真理	毅力	判决
	真实	义务	叛变
	针	议会	叛徒
	针对	音	庞大
	阵	阴谋	胖子
	睁	阴天	抛弃
	征求	银幕	刨
	争	饮料	炮火
	争论	引	跑道
	争取	引导	泡沫
	整个	引进	培训
	整理	隐约	赔款
	正	印染	配备
	正常	英镑	配方
	正好	英明	配偶
	正式	婴儿	配套
	政策	迎	喷射
	证明	影片	烹饪
	支持	应	烹调
	支援	应酬	批发
	之后	应付	批复
	之前	应邀	批改
	之上	硬	批示
	之下	哟	坯
	之一	拥挤	劈
	之中	踊跃	疲惫
	织	涌	疲乏
	职工	用品	皮带
	职业	用途	皮革
	直	用心	屁
	直	优胜	偏差
	直到	优势	偏见
	直接	优越	偏僻
	植物	邮包	偏向
	执行	犹豫	片刻
	值得	油田	漂
	指出	游	撇
	指导	游戏	瞥
	指挥	游行	拼搏
	指示	有机	频繁
	止	有两下子	频率
	只是	有限	贫
	只要	有一些	贫乏
	只有	有意	贫困
	至	有益	贫民
	至今	友爱	品
	至少	幼儿园	品尝
	制定	幼稚	品行
	制订	愚蠢	聘
	制度	余	聘请
	制造	渔民	聘任
	秩序	娱乐	聘用
	质量	与其	平面
	治	宇宙	平民
	中餐	语文	平日
	中心	浴室	平坦
	中央	愈…愈…	平稳
	中药	寓言	平整
	终于	预报	萍水相逢
	种子	预防	评比
	种子	预告	评定
	重大	预先	评估
	重点	预祝	评审
	重量	冤枉	评选
	重视	元旦	屏障
	周到	元素	颇
	株	元宵	婆婆
	逐步	原理	破除
	逐渐	原始	破获
	竹子	原先	破旧
	煮	原子	破裂
	主动	原子弹	破碎
	主观	援助	迫使
	主人	园林	扑克
	主任	圆满	扑灭
	主席	猿人	葡萄糖
	主张	缘故	仆人
	著名	愿	朴实
	著作	怨	普查
	住院	越	谱
	祝贺	跃进	谱曲
	抓	月光	瀑布
	抓紧	乐器	期待
	专家	晕	期刊
	专门	运气	期望
	专心	运转	期限
	专业	砸	七嘴八舌
	转	杂文	柒
	转变	杂志	凄惨
	转告	杂质	凄凉
	转	栽	漆黑
	庄稼	灾难	沏
	庄严	载	其间
	撞	载重	奇花异草
	状况	再三	奇妙
	状态	再说	奇特
	追	在于	歧视
	准	在座	齐全
	准确	赞美	旗号
	准时	赞扬	起草
	捉	遭	起点
	资料	遭遇	起伏
	资源	糟	起哄
	紫	凿	起劲
	仔细	早期	起码
	自	早晚	起身
	自从	早已	起诉
	自动	责备	岂不
	自费	增产	岂有此理
	自觉	增进	乞求
	自然	增强	启程
	自我	赠送	启示
	自学	扎实	启事
	自由	渣	砌
	综合	炸	器
	总结	炸	器具
	总理	债	器械
	总统	沾	气喘
	走道	盏	气功
	组	崭新	气力
	钻	占领	气流
	钻研	占有	气魄
	醉	战场	气球
	最好	战略	气势
	尊敬	战术	气息
	遵守	战线	汽
	左边	战友	掐
	左右	张	恰到好处
	做法	张望	恰巧
	做客	长	恰如其分
	做梦	掌声	洽谈
	作家	账/帐	牵扯
	作品	胀	牵引
	作为	障碍	牵制
	作文	招	千军万马
	作用	招手	千瓦
	作者	着凉	迁
	坐班	照例	迁就
	座谈	照相机	签发
	座位	照样	签名
		照耀	签署
		罩	签证
		召集	签字
		遮	谦逊
		折合	前辈
		折磨	前程
		者	前赴后继
		这会儿	前景
		这样一来	前列
		珍贵	前期
		珍惜	前人
		珍珠	前所未有
		真是	前提
		针灸	前往
		枕头	前线
		震	钳子
		震动	潜伏
		振动	潜力
		镇	谴责
		镇静	嵌
		镇压	枪毙
		阵地	腔
		蒸发	强化
		蒸汽	强盛
		挣扎	强制
		征	抢劫
		征服	抢救
		争夺	锹
		整	乔装
		整顿	侨胞
		整风	茄子
		整体	窃取
		正当	窃听
		正经	钦佩
		正面	侵害
		正义	侵蚀
		政党	侵占
		政权	亲笔
		症状	亲密
		挣	亲身
		证件	亲生
		证据	亲手
		证实	亲友
		证书	勤
		枝	勤奋
		支	勤工俭学
		支配	勤俭
		知	勤恳
		知识分子	芹菜
		之	禽
		之	轻便
		之类	轻工业
		之内	轻快
		之外	轻微
		职员	氢
		直达	蜻蜓
		直径	倾听
		殖民地	倾斜
		值	清查
		指标	清理
		指点	清新
		指南针	清早
		指头	清真寺
		指引	晴朗
		只得	情感
		志愿	情节
		至于	情理
		致	请柬
		制	请帖
		制止	请愿
		制作	庆贺
		智慧	穷苦
		质	秋收
		治疗	球队
		中部	球迷
		中断	求得
		中年	趋势
		中旬	趋向
		中医	区分
		忠诚	曲线
		忠实	屈服
		衷心	驱逐
		终身	取代
		种类	曲子
		肿	去世
		中	圈套
		种植	权
		周末	权威
		周年	权限
		粥	权益
		皱	泉
		皱纹	全都
		嘱咐	全会
		主持	全集
		主力	全力
		主权	全力以赴
		柱子	全民
		助	全心全意
		助手	犬
		铸	劝说
		住宅	劝阻
		注射	券
		注视	缺口
		祝愿	缺席
		驻	缺陷
		专	瘸
		专政	确保
		砖	确立
		转播	确切
		转达	确认
		转动	确信
		转化	确凿
		转入	群体
		转弯	燃
		转移	让步
		赚	扰乱
		转动	热潮
		桩	热泪盈眶
		装备	人道主义
		装饰	人格
		装置	人均
		幢	人情
		壮	人权
		壮大	人参
		壮丽	人身
		追求	人生
		着手	人事
		着重	人为
		资本	人性
		资本家	人质
		资本主义	仁慈
		资产阶级	任命
		资格	认定
		资金	认可
		姿势	日光
		姿态	荣誉
		子	融化
		子弹	融洽
		自豪	熔
		自来水	溶
		自满	溶化
		自身	溶解
		自始至终	容积
		自私	容量
		自相矛盾	容纳
		自信	容忍
		自言自语	绒
		自愿	柔和
		自治	如意
		自治区	如醉如痴
		自主	乳
		字典	入境
		字母	入口
		宗教	入侵
		宗派	入手
		总	入学
		总得	软件
		总而言之	锐利
		总共	瑞雪
		总算	弱点
		总之	撒谎
		走后门儿	腮
		走廊	三番五次
		走弯路	三角
		租	叁
		足	散发
		足	桑树
		祖父	扫除
		祖母	杀害
		祖先	刹车
		阻碍	沙
		阻力	沙滩
		阻止	沙土
		组成	砂
		组长	傻子
		嘴唇	厦
		罪	筛
		罪恶	筛子
		罪行	珊瑚
		尊重	山冈
		作风	山沟
		作物	山河
		作战	山脚
		座儿	山岭
			山水
			山头
			山腰
			闪耀
			擅长
			擅自
			善
			善良
			伤痕
			伤员
			商
			商标
			商榷
			商讨
			商议
			赏
			晌午
			上报
			上层
			上等
			上交
			上进
			上空
			上任
			上诉
			上台
			上涨
			尚
			梢
			捎
			烧饼
			烧毁
			少量
			少数民族
			哨
			奢侈
			舍
			摄
			涉及
			涉外
			社
			社员
			设立
			设施
			设置
			申报
			申述
			呻吟
			伸手
			伸展
			深奥
			深沉
			深处
			深化
			深浅
			深切
			深情
			深信
			深远
			深重
			绅士
			神奇
			神色
			神态
			神仙
			审
			审定
			审理
			审美
			审判
			审批
			审讯
			审议
			肾炎
			渗
			渗透
			声势
			声誉
			生产力
			生产率
			生机
			生命力
			生怕
			生前
			生人
			生疏
			生态
			生效
			生育
			生殖
			牲口
			牲畜
			升学
			省会
			省略
			盛
			盛产
			盛大
			盛开
			盛情
			盛行
			师
			师长
			失
			失事
			失误
			失效
			失学
			失约
			失踪
			施
			施肥
			施加
			施行
			施展
			湿度
			诗歌
			尸体
			十全十美
			十足
			石灰
			拾
			时
			时而
			时光
			时髦
			时事
			时装
			食
			食用
			食欲
			实
			实惠
			实力
			实体
			实物
			识
			识别
			史
			史料
			使节
			使命
			屎
			始
			式
			式样
			示范
			示意图
			侍候
			世
			世代
			世界观
			事变
			事例
			事态
			事项
			誓言
			势必
			释放
			市民
			视
			视察
			视觉
			视力
			视线
			视野
			试行
			试用
			试制
			收藏
			收成
			收复
			收购
			收回
			收买
			收益
			收支
			手电筒
			手法
			手巾
			手榴弹
			手艺
			首创
			首领
			首脑
			首席
			首相
			首要
			首长
			守法
			守卫
			授
			授予
			受伤
			输出
			输入
			输送
			舒展
			疏忽
			书法
			书刊
			书面
			书写
			书信
			属
			树干
			竖
			数额
			衰老
			衰退
			帅
			爽快
			水产
			水电
			水土
			水源
			水灾
			水蒸气
			税收
			顺序
			说谎
			说情
			斯文
			思
			思潮
			思前想后
			思绪
			私营
			私有制
			私自
			司法
			司令部
			死刑
			寺
			四方
			四季
			四肢
			肆
			似
			似是而非
			似笑非笑
			饲料
			耸
			搜
			搜查
			搜索
			苏醒
			俗
			素
			素质
			塑造
			诉讼
			肃清
			蒜
			算盘
			算术
			随时随地
			随意
			随着
			岁月
			穗
			隧道
			损
			损耗
			损人利己
			损伤
			笋
			索性
			所得
			所得税
			所属
			所有权
			所有制
			他人
			台风
			台阶
			泰然
			太空
			太平
			太阳能
			贪
			贪污
			瘫痪
			痰
			坛
			潭
			谈天
			坦白
			探测
			探亲
			探讨
			探头探脑
			探望
			叹
			炭
			塘
			糖果
			滔滔不绝
			桃花
			逃荒
			逃跑
			逃走
			淘气
			淘汰
			陶瓷
			讨
			讨价还价
			特产
			特地
			特定
			特区
			特权
			特色
			特性
			特意
			藤
			腾
			疼痛
			提案
			提拔
			提交
			提炼
			提名
			提取
			提升
			提示
			提要
			提早
			题材
			体
			体谅
			体贴
			体验
			体制
			体质
			体重
			剃
			替代
			替换
			天长地久
			天地
			天色
			天生
			天堂
			天线
			填补
			填写
			田间
			田径
			条款
			条理
			条文
			条子
			调和
			调剂
			调解
			挑
			挑拨
			挑衅
			挑战
			跳高
			跳远
			跳跃
			铁道
			铁饭碗
			听话
			听取
			听众
			停泊
			停顿
			停滞
			挺拔
			挺立
			艇
			通报
			通道
			通风
			通告
			通航
			通红
			通货膨胀
			通商
			通俗
			通行
			通讯社
			通用
			同步
			同等
			同行
			同类
			同年
			同期
			同事
			同一
			童年
			捅
			统筹
			统战
			痛恨
			偷窃
			偷税
			投标
			投产
			投放
			投机倒把
			投票
			投掷
			投资
			头子
			透彻
			透明度
			秃
			凸
			图案
			图表
			图片
			图像
			图形
			图纸
			屠杀
			团聚
			团圆
			推测
			推来推去
			推理
			推论
			推算
			推销
			推行
			推选
			退出
			退还
			屯
			拖延
			脱落
			椭圆
			妥
			妥善
			妥协
			唾沫
			挖掘
			瓦解
			外表
			外宾
			外出
			外电
			外观
			外行
			外汇
			外力
			外流
			外婆
			外事
			外向型
			外形
			外资
			豌豆
			湾
			玩具
			玩弄
			完毕
			完蛋
			晚餐
			晚年
			惋惜
			万水千山
			汪洋
			王
			王国
			亡
			往常
			往返
			往后
			往年
			往日
			往事
			望远镜
			忘却
			妄图
			妄想
			威风
			威力
			威望
			威信
			微不足道
			微观
			危急
			违法
			违犯
			桅杆
			围攻
			围棋
			唯物论
			唯物主义
			唯心论
			唯心主义
			惟独
			惟一
			为期
			维修
			伪造
			尾
			未免
			畏
			畏惧
			为何
			温度计
			温柔
			瘟疫
			文
			文盲
			文凭
			文人
			文献
			文雅
			文言
			稳当
			稳妥
			问答
			问世
			窝
			窝囊
			卧室
			乌鸦
			乌云
			污蔑
			巫婆
			诬陷
			呜咽
			无偿
			无耻
			无从
			无非
			无话可说
			无可奉告
			无理
			无聊
			无能为力
			无情无义
			无穷
			无所作为
			无微不至
			无效
			无意
			无知
			梧桐
			武力
			伍
			舞
			舞厅
			物
			物力
			勿
			务必
			悟
			误差
			误解
			吸毒
			膝盖
			熄
			熄灭
			溪
			席
			席位
			习俗
			习题
			喜
			喜鹊
			喜事
			喜讯
			洗涤
			系列
			细节
			细小
			峡
			狭隘
			狭窄
			霞
			下达
			下放
			下级
			下令
			下落
			下台
			下乡
			掀起
			先锋
			先前
			先行
			仙女
			鲜红
			弦
			嫌疑
			贤惠
			衔
			衔接
			显
			显而易见
			显微镜
			现场
			现金
			现钱
			现行
			现状
			献身
			县长
			馅儿
			陷害
			陷入
			限
			限度
			限期
			限于
			线索
			相比
			相差
			相等
			相符
			相关
			相继
			相交
			相识
			相通
			相应
			镶
			香味
			乡亲
			想方设法
			响声
			享福
			享乐
			享有
			项链
			橡胶
			橡皮
			向往
			象棋
			像样
			销
			销毁
			销路
			销售
			消
			小鬼
			小米
			小数
			小数点
			小提琴
			小心翼翼
			小型
			小学生
			小子
			校徽
			校园
			肖像
			效力
			效益
			孝顺
			协商
			协调
			协议
			挟持
			邪
			携带
			泻
			泄
			泄露
			泄气
			谢绝
			屑
			锌
			欣欣向荣
			新陈代谢
			新房
			新近
			新郎
			新娘
			新人
			新兴
			新颖
			心里
			心灵
			心目
			心疼
			心头
			心血
			心眼儿
			心愿
			心中
			薪金/薪水
			信贷
			信件
			信赖
			信仰
			信用
			信誉
			星
			腥
			兴
			兴办
			兴建
			兴起
			兴旺
			刑
			刑场
			刑法
			刑事
			型
			型号
			形
			形而上学
			行程
			行贿
			行径
			行军
			行使
			幸好
			幸运
			性命
			性情
			杏
			兄
			凶狠
			凶猛
			胸怀
			胸膛
			汹涌
			雄厚
			雄壮
			熊
			休养
			修订
			修复
			修养
			羞耻
			嗅
			秀丽
			袖子
			需求
			虚
			虚假
			虚弱
			虚伪
			须知
			徐徐
			许可
			蓄
			酗酒
			叙谈
			序言
			畜产品
			畜牧
			絮叨
			续
			宣称
			宣读
			宣誓
			宣扬
			悬挂
			悬念
			旋
			旋律
			选拔
			选定
			选集
			选民
			选取
			选手
			选用
			削减
			削弱
			靴子
			学历
			学派
			穴
			雪白
			血压
			熏
			循序渐进
			巡逻
			寻求
			训
			讯
			压抑
			押韵/压韵
			鸦片
			崖
			哑
			轧
			烟草
			烟卷儿
			烟雾
			淹没
			严寒
			严峻
			延缓
			延期
			延伸
			延续
			言
			言论
			言语
			炎热
			沿岸
			沿途
			掩
			掩饰
			眼力
			眼色
			眼神
			眼下
			演变
			演唱
			演讲
			演算
			演习
			演奏
			宴请
			宴席
			验
			验收
			验证
			杨树
			阳
			氧
			痒
			养分
			养活
			养育
			养殖
			样品
			邀
			妖怪
			遥控
			药材
			要领
			要么
			要命
			要素
			耀眼
			野
			野蛮
			野生
			野外
			野心
			冶炼
			夜班
			液
			一辈子
			一旦
			一度
			一帆风顺
			一概
			一概而论
			一干二净
			一个劲儿
			一贯
			一哄而散
			一会儿…会儿…
			一技之长
			一举
			一律
			一毛不拔
			一身
			一手
			一头
			壹
			医
			医务
			医药
			医治
			依
			依次
			依赖
			衣裳
			遗传
			遗失
			遗体
			遗址
			移民
			疑惑
			疑难
			以免
			以身作则
			以往
			以至于
			亿万
			亦
			意料
			意图
			意向
			毅然
			忆
			议案
			议程
			议定书
			议员
			译员
			异
			翼
			因
			音响
			阴暗
			淫秽
			饮
			饮食
			饮水思源
			引人注目
			引入
			引用
			引诱
			隐蔽
			隐藏
			隐瞒
			英俊
			鹰
			樱花
			营
			蝇子
			迎面
			赢得
			赢利/盈利
			硬件
			映
			拥有
			庸俗
			涌现
			永垂不朽
			永久
			勇士
			勇于
			用法
			用户
			用具
			用人
			用意
			幽静
			幽默
			优
			优惠
			优先
			优异
			优质
			忧虑
			忧郁
			由此可见
			邮电
			邮购
			邮寄
			邮政
			铀
			犹如
			油菜
			油画
			油料
			油漆
			游击
			游客
			游人
			有待
			有害
			有口无心
			有声有色
			友情
			友人
			诱
			诱惑
			幼
			愚昧
			舆论
			渔业
			榆树
			予
			予以
			雨伞
			雨水
			与此同时
			与会
			羽毛
			玉
			愈
			欲
			欲望
			寓
			预测
			预定
			预订
			预计
			预见
			预料
			预期
			预赛
			预算
			预言
			预约
			冤
			元件
			元首
			原
			原材料
			原告
			原油
			原子能
			园
			源
			源泉
			远大
			远方
			远景
			曰
			约束
			越冬
			越过
			跃
			月份
			乐队
			乐曲
			阅
			云彩
			匀
			运送
			运算
			运行
			蕴藏
			酝酿
			孕育
			杂交
			杂乱
			栽培
			灾荒
			宰
			再生产
			在乎
			在意
			攒
			暂
			暂且
			赞赏
			赞叹
			赞同
			赞助
			葬
			葬礼
			遭殃
			糟蹋
			枣
			早点
			早日
			噪音
			造反
			造价
			造型
			灶
			责怪
			责任制
			贼
			怎
			怎么着
			增
			增设
			增添
			增援
			闸
			眨
			炸弹
			炸药
			诈骗
			榨
			摘要
			寨
			债务
			瞻仰
			沾光
			斩
			斩草除根
			斩钉截铁
			展示
			展望
			展现
			展销
			占据
			战
			战役
			站岗
			章程
			掌
			掌管
			涨价
			招聘
			招生
			招收
			朝气
			朝气蓬勃
			朝三暮四
			沼泽
			兆
			照会
			照旧
			照料
			照明
			照射
			照应
			折腾
			这么着
			真诚
			真是的
			真相
			真心
			侦察
			侦探
			诊断
			震荡
			震惊
			振
			振奋
			振兴
			镇
			镇定
			阵容
			阵线
			阵营
			正月
			蒸
			征收
			争吵
			争端
			争气
			争先恐后
			争议
			整洁
			整数
			整天
			整整
			正比
			正规
			正气
			正巧
			政变
			政协
			症
			郑重
			证
			芝麻
			支部
			支撑
			支出
			支付
			支票
			支柱
			知觉
			蜘蛛
			脂肪
			汁
			职称
			职能
			职权
			职务
			直播
			直辖市
			直线
			直至
			植
			殖民主义
			执法
			执勤
			执照
			执政
			值班
			侄子
			指定
			指甲
			指令
			指明
			指手画脚
			指望
			指针
			只顾
			只管
			只能
			纸张
			志
			志气
			掷
			至多
			致词
			致电
			致富
			致敬
			致使
			置
			制裁
			制服
			制品
			制约
			智力
			智能
			质变
			质朴
			治安
			治理
			中等
			中立
			中秋
			中途
			中型
			中游
			中原
			忠于
			忠贞
			钟表
			钟点
			终
			终点
			终端
			终究
			终年
			终止
			种种
			种族
			肿瘤
			种地
			重工业
			重心
			重型
			众
			众多
			众人
			众所周知
			众议院
			舟
			周密
			周期
			周折
			周转
			州
			洲
			昼夜
			珠子
			诸如此类
			诸位
			逐年
			拄
			嘱托
			主
			主办
			主编
			主导
			主管
			主流
			主人翁
			主食
			主题
			主体
			主义
			著
			助理
			助长
			铸造
			筑
			住房
			住所
			注册
			注解
			注目
			注释
			注重
			祝福
			驻扎
			爪
			拽
			专长
			专程
			专科
			专利
			专人
			专题
			专业户
			专用
			专制
			转换
			转交
			转让
			转向
			转折
			传
			传记
			庄
			庄重
			装配
			装卸
			壮观
			壮烈
			壮志
			追查
			追悼
			追赶
			追究
			追问
			准许
			准则
			卓越
			啄
			酌情
			着
			着想
			咨询
			资产
			资助
			滋味
			滋长
			籽
			子弟
			子孙
			自卑
			自发
			自负盈亏
			自古
			自力更生
			自杀
			自私自利
			自卫
			自行
			自由市场
			踪迹
			宗旨
			棕色
			总的来说
			总督
			总额
			总和
			总计
			总数
			总司令
			总务
			纵横
			走访
			走狗
			走漏
			走私
			走向
			奏
			揍
			租金
			足以
			族
			阻挡
			阻拦
			阻挠
			组合
			钻石
			嘴巴
			罪犯
			罪名
			罪状
			尊
			尊称
			尊严
			遵循
			遵照
			琢磨
			做工
			作案
			作法
			作废
			作主
			座右铭
