WritWord_level_1	WritWord_level_2	WritWord_level_3	WritWord_level_4
国	出版	自信	侵入
大	竞争	诸多	冷落
出	悉	屡	荒唐
经	充分	屡次	名言
过分	痛	脱离	竞相
方	扩大	连接	虔诚
前	推动	询问	远景
自	综合	尝试	公仆
者	途	抗议	过问
同	执行	颈	刻意
本	于是	内涵	英明
实	掌	拍摄	启迪
重新	误	派遣	浏览
之	交流	赋予	交错
定	暴	奇迹	珍藏
将	调整	随即	情操
力	致	开办	稍微
当	屋	生机	格调
合	参与	近来	不畏
外	幸	纠正	误导
已	选择	一再	交织
内	制定	灾难	精湛
两	避	阐述	奢侈
明	概	热爱	回首
但	勇	盲目	外省
此	无法	偶然	洁净
并	敌	加紧	前行
今	举办	干预	未知
特	聚	抑制	田地
代	集中	处处	陶醉
因	显示	不堪	执著 
情	厚	开设	执着
各	秋	防范	壮丽
发展	渐	梦想	缅怀 
资	诚	文献	端正
及	及其	遇难	抉择
相	患	历程	败坏
解	左右	渴望	抚摸
据	意识	和谐	杰作
结	友好	变革	摇篮
决	贡献	途中	骤然
计	享	丧失	快车
果	相信	当场	呻吟
共	骨	设法	愚昧
改	佳	自豪	遗忘
近	符	防御	衣着
知	暗	崛起	悬殊
至	更加	提倡	追溯
身	趋	测试	敏捷
更	是否	陌生	深渊
信	拥有	瞩目	就绪
进行	残	生涯	精通
增	忽	争论	直奔
广	高度	掌声	固执
反	另外	不易	辗转
感	冬	取代	华裔
专	明确	缩小	别致
深入	保障	可谓	轮廓
该	建筑	装饰	驾驭
快	兼	气质	畏惧
允许	维护	崇高	跋涉
必	宜	匆匆	真切
确	刊	蔓延	相符
何	回答	暴露	避难
始	似乎	干涉	匮乏
思	改善	安定	偶像
全国	纯	中断	专注
续	推进	无不	惨重
准	丰富	进而	充沛
单独	此外	涉嫌	情调
精	从而	注目	惊异
具	完善	境界	浮现
则	殊	何况	代办
择	武装	骄傲	满腔
备	邀	谨慎	掠夺
需要	大力	合成	践踏
连	制造	防守	难堪
即	横	推迟	荒凉
切合	关注	格外	轻微
需	并且	罕见	天赋
未	增强	感慨	挑衅
境	倍	进军	渊源
往	规划	承办	嫉妒
易	必要	分明	毕生
获	严格	问世	聆听
言	面临	顿时	呼啸
职务	公开	惊讶	不妥
断	立即	垄断	窒息
足够	灭	封锁	
较	导致	互补	珍视
助	晨	无奈	刷新
亲自	证明	涌现	屏障
成为	难以	高大	头衔
案	相互	依旧	肇事
突然	普遍	荣获	耕耘
尽	动员	进取	风趣
举行	突破	灿烂	波澜
速	返回	伴随	遗弃
快速	甘	历时	默契
料	甘心	消耗	坚韧
改革	给予	不解	初衷
乐	猛	修正	推崇
终	窗	氛围	狂欢
紧	从事	长久	缤纷
另	符合	瞬间	真挚
以及	惯	蓬勃	天涯
发生	依法	披露	惋惜
轻	恐怖	较量	培植
承	奔	宏伟	荒谬
善	暂	充实	索取
围	所谓	反响	巡视
建立	有所	空前	谋生
飞	呼吁	震惊	喝彩
良	贯彻	燃烧	瓦解
春	袭击	尽力	雄伟
语	徒	完美	主宰
虽	采用	敦促	繁衍
校	解释	急需	给以
余	寒	除非	宝库
景	加工	步入	萧条
提供	欲	筹集	凄凉
解决	损失	应邀	对峙
独	设立	经受	崇敬
报道	处于	流传	侥幸
开发	体现	而后	鉴赏
故	巧	违背	后裔
似	桌	无比	蕴含
困境	充满	描绘	照例
害	达成	固然	光泽
国内	伟大	摧毁	怜悯
久	永远	深感	观望
尝试	直到	敢于	亲临
喜	当年	忍受	光顾
险	担任	弥补	受挫
苦	承认	气息	坦然
增加	治疗	独自	尾声
额头	妙	未必	迟早
奇怪	复杂	廉洁	骚扰
基本	俱	姿态	傲慢
取得	经历	事宜	不愧
不断	成就	幽默	清澈
具有	位于	擅自	悲壮
不同	切实	犹如	畸形
否	邻	勉强	波及
急	应用	春秋	叮嘱
细	不住	漫长	欺负
停	即将	孤独	领悟
共同	破坏	不许	诧异
经营	涉及	角逐	殴打
遇	镜	本着	棘手
获得	探索	历来	归宿
进入	不管	严密	牵涉
互	狂	布置	时隔
负责	本人	寂寞	贪婪
馆	避免	谈论	终日
顿	预计	创立	修筑
巨大	评价	有害	盘旋
采取	掌握	残酷	惭愧
既	污染	驱逐	机智
虽然	彼	内战	速成
简	频	倘若	气概
不仅	孤	分享	莫非
促进	承担	测量	资质
经过	观察	四季	充斥
永	构成	媒介	松懈
关于	购买	不免	点缀
园	决策	观测	气魄
调查	实验	动荡	混淆
微	发动	轻易	放眼
全面	肩	缓缓	寻觅
剧烈	所在	视野	席卷
开展	前往	特写	忘却
不知	本来	赞助	潜伏
错	标志	神奇	典雅
结束	非法	挣扎	执意
甚至	限制	风暴	催促
强调	追求	歧视	深邃
当时	因而	偶尔	写照
全部	运用	征求	精髓
保持	遇到	观赏	融洽
成立	依然	康复	佳作
发挥	停止	尴尬	名贵
恐	战胜	重任	倾倒
季	日益	响应	踌躇
来自	不但	借口	触犯
平静	防止	租赁	激化
私	大批	迅猛	奔腾
固	畅	共享	斯文
重大	高速	此案	隐私
衣	遇到	冒险	家境
齐	合法	传达	无害
彩	总结	温柔	理睬
统一	一旦	辩论	表率
遍	紧急	等候	旅程
然而	机遇	珍惜	重温
尤	一行	观光	显赫
超出	研制	起源	缩影
一定	尊重	以免	抗衡
必定	加以	责令	开明
将来	赢得	无穷	沐浴
全力	评论	衷心	激昂
联合	交换	养成	爱戴
已经	必然	征服	熏陶
特地	防治	隐患	狭隘
代替	意味	前人	狼狈
因为	境内	青睐	横行
情况	表达	轰动	歼灭
资金	现	缓和	平庸
理解	愈	勇于	热忱
缔结	盗	再现	衣食
结成	享受	扭转	楷模
决定	修改	目睹	殷切
计算	予以	身为	赫然
果然	仿佛	单打	相聚
改变	并非	声誉	纵观
自身	开拓	排列	质朴
本身	更为	往事	炫耀
戏剧	权益	猛烈	精辟
感到	负担	争端	苦练
专门	相同	投身	回味
的确	途径	反抗	抑郁
开始	饱	力求	酷暑
思考	妥	聚会	镶嵌
思念	强化	灌溉	摧残
继续	转移	展望	年薪
批准	尘	明明	顾及
边境	外商	竭力	敬畏
境况	围绕	显现	晶莹
容易	维持	枢纽	重创
帮助	办理	邻国	踪影
案件	否则	吸取	动听
料想	监狱	万分	苛刻
最终	履行	投机	艳丽
擅长	签订	忽略	威慑
包围	皆	艰辛	钟情
飞快	进攻	向往	驳斥
剩余	具备	尤为	症结
余下	禁止	适宜	风靡
景色	消除	不宜	忘我
光临	严肃	陡然	后盾
加害	当代	陡	今春
恐怕	提前	传奇	厌倦
危险	改进	一经	蔑视
辛苦	希望	不料	要不然
简单	与其	堪称	屹立
	激动	取缔	含蓄
	预防	贿赂	驰骋
	鼻	沉思	莫过于
	占领	拯救	消逝
	传播	趋于	乞丐
	本国	寻觅	洗礼
	信任	觅	流逝
	知名	暂行	兼容
	装备	闪烁	奏效
	多么	慷慨	质问
	气氛	粉碎	唯独
	既然	序幕	连绵
	狠	历经	媲美
	逢	滥用	徐徐
	损害	满怀	憔悴
	巩固	时分	确凿
	极为	流露	畅谈
	牺牲	游览	扬言
	私下	勿	见地
	加速	繁华	健在
	爆发	脸颊	径直
	克服	颊	笔直
	辉煌	笼罩	敬重
	以往	陈列	轻蔑
	酷	逃避	回荡
	到达	往日	介意
	近期	下落	乏味
	遭受	深思	假使
	一度	行径	高薪
	大战	倾听	古朴
	毕竟	不甘	厄运
	紧密	信赖	滋润
	检验	辛勤	收敛
	等待	献身	颤动
	发射	黄昏	羞愧
	斜	依次	忘怀
	危害	徘徊	浩劫
	富有	不予	开动
	活跃	宁静	险恶
	汇报	落成	安详
	整顿	才华	敷衍
	呈现	互助	底蕴
	职责	洋溢	倾诉
	不及	万万	明媚
	普及	知情	漫游
	色彩	无辜	裸露
	继承	欣慰	幸免
	简直	奇特	丑陋
	薪水	黎明	松弛
	迄今	刻苦	浓重
	详细	郑重	称职
	奉献	散步	寓意
	不论	料到	故土
	格局	自负	赞许
	惧	踊跃	清脆
	陷入	仍旧	耸立
	小康	叹息	单行
	保留	从容	盛产
	渐渐	每逢	两难
	相继	递增	纵容
	凌晨	开枪	自卑
	出色	复制	内幕
	减轻	自尊	抑或
	遵守	花卉	颠簸
	严峻	新颖	凯旋
	发扬	淹没	搁浅
	率先	不乏	巨著
	同行	泛滥	下意识
	致力	潇洒	佼佼者
	严厉	崩溃	徒劳
	观看	告诫	簇拥
	竟然	优异	换言之
	纵横	震撼	范例
	出售	清新	祈求
	争夺	一味	僵化
	企图	毅然	独立
	使命	无非	酷爱
	制定	降临	荒诞
	制订	况且	内疚
	开辟	纯洁	眺望
	赔偿	接力	闭塞
	兴建	长足	枯竭
	而已	质疑	胆识
	象征	无聊	离职
	兹	掩盖	信条
	小心	严禁	迷恋
	精心	不善	荡漾
	新增	变迁	胆怯
	极其	改编	即刻
	国情	敏锐	捷径
	引领	流浪	抱负
	力争	茫茫	自理
	异常	弥漫	连载
	如同	高雅	宜人
	创建	抵御	周旋
	不良	转入	梦境
	增进	压抑	未尝
	畏	浓郁	恳切
	鉴定	备受	权衡
	安装	乐园	诽谤
	挫	次要	丰盛
	较为	钦佩	魄力
	地处	亲手	月薪
	期待	桂冠	慈祥
	写作	广泛	巨款
	足以	改正	逊色
	授予	萎缩	切磋
	借鉴	手脚	盛情
	不准	损坏	铭记
	记载	集合	间隙
	侵略	再三	重逢
	颁布	攀登	空旷
	无限	严谨	渺茫
	淘汰	焕发	瞻仰
	被迫	完备	沉静
	致使	列举	倾心
	遭遇	蓝图	嘲弄
	不禁	患有	扼杀
	精彩	改良	玲珑
	过于	兼顾	芬芳
	驾驶	壮观	锦绣
	表彰	时髦	周折
	阅读	虐待	追忆
	调节	掩饰	仿效
	窃	轮流	黯淡
	魅力	并存	敌意
	不时	疲惫	酗酒
	保卫	宽容	妄想
	互利	由衷	无意识
	枯	捕捉	宽恕
	近代	心声	涵义
	参考	寄托	渊博
	展现	典范	恢弘
	清晰	坐落	仁慈
	善于	诚挚	荆棘
	建造	美化	煎熬
	资助	侮辱	敬仰
	擅	求职	逆境
	凝聚	疲倦	奴役
	期望	阐明	绰号
	奠定	着实	羞涩
	一向	弊端	飞奔
	辞职	温馨	表白
	沉默	自学	强项
	差异	无从	荣辱
	喜爱	合计	荒芜
	集资	何等	神往
	诉讼	感触	妄图
	一举	奔波	陶冶
	为何	废弃	斥责
	消灭	坦率	发型
	杰出	曙光	粗略
	激励	开端	瑰宝
	开创	屡次	提防
	延长	越发	仓促
	阻止	废除	凉爽
	假如	奔驰	装帧
		举止	眷恋
		焦虑	轮番
		天性	须知
		情趣	阅历
		追逐	划时代
		简陋	豪情
		礼拜	悲愤
		与否	鸿沟
		请教	炽热
		仇恨	虚幻
		朦胧	文雅
		精致	悦耳
		审视	委婉
		废墟	豪迈
		濒临	闲暇
		相近	慈爱
		领略	推敲
		匆忙	渺小
		茫然	刺耳
		置身	爱慕
		总计	粗犷
		无愧	神韵
		忧郁	易懂
		时而	忌讳
		沮丧	示弱
		迟疑	装束
		镇压	悉心
		启程	沦陷
		不朽	嬉戏
		雕刻	怒吼
		无视	拘束
		了结	放纵
		著称	赡养
		有幸	粗鲁
		晋升	轻率
		迷惑	破译
		和睦	标榜
		战乱	过目
		责备	挺拔
		嘲笑	掠夺
		公然	膳食
		沧桑	碧绿
		抨击	苦学
		当真	漂泊
		刹那	火速
		一概	浸透
		解脱	母校
		钻研	乞讨
		采纳	耳闻
		歪曲	慰藉
		过早	响彻
		险情	英姿
		学子	直率
		欺诈	洒脱
		醒目	暂且
		反之	鄙视
		稳健	征询
		施展	惊诧
		专心	辈出
		源泉	淡泊
		兼任	调侃
		停滞	鞭策
		里程碑	清贫
		孕育	姑且
		寂静	稠密
		沉浸	歧途
		分外	苦死
		汲取	气馁
		坎坷	睿智
		流亡	景致
		无需	翠绿
		嗜	稳重
		嗜好	呜咽
		奔赴	兜售
		竭尽	本刊
		大肆	外力
		年华	哺育
		辽阔	错落
		华丽	斟酌
		无须	幽静
		并肩	伺机
		继而	陡峭
		沸腾	谦逊
		抚养	淳朴
		盛行	吹嘘
		猛然	依恋
		奇异	隔阂
		偏僻	窘迫
		启蒙	迷茫
		营救	飘荡
		奥秘	苍茫
		呐喊	今晨
		创伤	破折
		测验	仰慕
		隐约	窃取
		侵蚀	草率
		耀眼	泰然
		索性	剔除
		自如	久违
		冷漠	酷似
		升华	自责
		不屑	雅致
			宣泄
			奢望
			草拟
			补习
			挖苦
			切忌
			速递
			必修
			坦荡
			我校
			雷同
			孩童
			恶作剧
			寒暄
			枯萎
			貌似
			豪放
			底细
			酷热
			世故
			狂奔
			焦躁
			异乡
			污秽
			豁达
			倍感
			阻隔
			彷徨
			诬陷
			心酸
			商榷
			懒惰
			贴切
			断送
			暂缓
			怒放
			座右铭
			动容
			施舍
			修长
			刺骨
			代言人
			领教
			遨游
			饶恕
			悲凉
			沉沦
			孪生
			憨厚
			刚毅
			体魄
			藐视
			自爱
			招揽
			沉溺
			颓废
			苍凉
			文静
			外逃
			了却
			复辟
			本校
			卖弄
			准予
			挥洒
			游子
			灼热
			心田
			荒废
			干练
			忠贞
			加薪
			聪慧
			矫健
			淡忘
			私自
			倍加
			客套
			苛求
			诱饵
			潦倒
			标致
			器重
			商贾
			刁难
			朗读
			怜惜
			沦落
			哗然
			涉猎
			凌乱
			抄写
			恩赐
			淑女
			鲁莽
			履约
			冗长
			口碑
			险峻
			默然
			拙劣
			秉承
			遗愿
			冒昧
			儿戏
			机警
			强求
			惟独
			心扉
			箴言
			泰斗
			世袭
			抹杀
			绽开
			自荐
			神速
			口角
			繁茂
			宠儿
			娇小
			忘情
			敬礼
			嫌弃
			绚烂
			冷遇
			孩提
			捧场
			合著
			尽兴
			教唆
			暂定
			畅游
			纵情
			娇嫩
			仪态
			酣睡
			入神
			干戈
			口福
			复述
			寒酸
			敌国
			敦厚
			心仪
			羽翼
			企望
			畏难
			溺爱
			堆砌
			对弈
			诀别
			歉疚
			直爽
			过奖
			凋谢
			商洽
			强占
			怪罪
			挟持
			唐突
			承蒙
			恭候
			佳音
			乡愁
			奸诈
			飘飘然
			耿直
			酬谢
			停薪
			公论
			笑柄
			阔绰
			海量
			归罪
			凶悍
			褒扬
			余款
			申述
			邻座
			替罪羊
			白日梦
			刚劲
			纤弱
			刚健
			偶遇
			忘年交
			届时
			大方
			
			大度
			获悉
			欣闻
			唁电
			噩耗
